1111111111111111111111
10C111110000000000T1E1
1011111101111111111101
1X00000000000000000001
1011111110100111111111
10000000101001O0G111P1
1111111010111110111101
1000000000000000000001
1111111111111111111111