111111111111
1C0000000001
101000000001
1010000000E1
101000000001
100000111001
100000101111
1P0000000001
111111111111