11111111111111111
10C100000000100E1
10110001111110011
10100000000000001
10111000000111111
10000011100000001
10111110111111111
100000000000000P1
11111111111111111