111111111111
100000000001
1C1000001111
1110000000E1
100000001111
1000111000C1
10111C111111
1000000000P1
111111111111