1111111111111111111111
100000C1000000000001C1
10011111011111111111E1
1X00000000000000000001
1011111110000000111111
10000000101011100111P1
1111111010101110000001
1000000000000000000001
1111111111111111111111