1111111111111111111111
100C1111111111111111E1
1000000011111111111101
1001111011111111111X01
1001111000000111111001
10011111111100000P0001
1001111111111111111001
1000000000000000000001
1111111111111111111111